AlienHelpBot
An Interactive Fiction by Gregori, Lars
Release 1 / Serial number 161122 / Inform 7 build 6M62 (I6/v6.33 lib 6/12N) SD

Earth
Your spacecraft crashed on earth and it seems you are lost.

First of all: WELCOME ON EARTH.

Feel free to look around.

>i
You are carrying:
  a telephone

>look telephone
The telephone is an old telephone with a dial plate. We don't support them on earth.

>south
Mud Volcano
There is a black mud volcano in the dessert. He usually only ooze mud, but we can support a volcane insurance.

* * *

>i
You are carrying:
  a telephone

>x telephone
The telephone is an old telephone with a dial plate. I think we don't support them on earth.

>south
Mud Volcano
There is a black mud volcano in the dessert. He usually only ooze mud, but we can support a volcane insurance.

You can see a volcano insurance here.

>look volcano insurance
The Volcano Insurance FST-42 protects you against predictable volcano explosions.

>take volcano insurance
Taken.

>i
You are carrying:
  a volcano insurance
  a telephone

* * *

AlienHelpBot
An Interactive Fiction by Gregori, Lars
Release 1 / Serial number 161122 / Inform 7 build 6M62 (I6/v6.33 lib 6/12N) SD

Earth
Your spacecraft crashed on earth and it seems you are lost.

First of all: WELCOME ON EARTH.

Feel free to look around.

>l telephone
The telephone is an old telephone with a dial plate. I think we don't support them on earth.

>dial 911 with telephone
That's not a verb I recognise.

>telephone eae
That's not a verb I recognise.

>use telephone
That's not a verb I recognise.

>talk telephone
That's not a verb I recognise.

>x telephone
The telephone is an old telephone with a dial plate. I think we don't support them on earth.

* * *

AlienHelpBot
An Interactive Fiction by Gregori, Lars
Release 1 / Serial number 161122 / Inform 7 build 6M62 (I6/v6.33 lib 6/12N) SD

Earth
Your spacecraft crashed on earth and it seems you are lost.

First of all: WELCOME ON EARTH.

Feel free to look around.

>look
Earth
Your spacecraft crashed on earth and it seems you are lost.

First of all: WELCOME ON EARTH.

Feel free to look around.

>s
Mud Volcano
There is a black mud volcano in the dessert. He usually only ooze mud, but we can support a volcane insurance.

>inspect
That's not a verb I recognise.

>i
You are carrying:
  a telephone

>look telephone
The telephone is an old telephone with a dial plate. I think we don't support them on earth.